		// migemo-dictの追加辞書(Mecab辞書から変換)
		// 最終更新: 2018/03/19 BowmoreLover
		// 本辞書の用途について:
		// ・migemo-dictにマージすることを想定した追加辞書
		// ・辞書キーを置き換えるのではなく、候補列への置き換え/追加を想定している
		// ・migemo-dictとは異なり、本ファイルではタブで始まる行はコメント扱い
		// 本辞書の内容:
		// ・別ツール用に作成したTES/Fallout/TW3用語Mecab辞書から、次の用語を抽出して変換したもの
		//   名詞、副詞、連体詞
		// ・Mecab辞書はMecabで「読めない」用語だけが対象なので、全ての用語を網羅していない点に注意

りふてんすくりぷとしーんとりで	リフテンスクリプトシーン砦
さくすりーるりびんぐるーむけ	サクスリールリビングルーム家
さすらむだいのうえんこうげん	サスラム大農園高原
すとーんしぇーぱーさんちょう	ストーンシェーパー山頂
ぶろーくんすとりーむこうざん	ブロークンストリーム鉱山
ろすとないふどうくつこうざん	ロストナイフ洞窟鉱山
あいあんぶれーかーこうざん	アイアンブレーカー鉱山
くれいどるくらっしゅとりで	クレイドルクラッシュ砦
ちーずるしゅりーくこうざん	チーズルシュリーク鉱山
にるんくらっつはいこうざん	ニルンクラッツ廃鉱山
ほわいとふぉーるさんちょう	ホワイトフォール山頂
ぼーんすとるーんさんみゃく	ボーンストルーン山脈
ぼーんすとれうんさんみゃく	ボーンストレウン山脈
ろすとぷろすぺくとこうざん	ロストプロスペクト鉱山
いりあすせいどうこうざん	イリアス聖堂鉱山
うぉーたーさいどこうざん	ウォーターサイド鉱山
えんばーしゃーどこうざん	エンバーシャード鉱山
えんばーふりんとこうざん	エンバーフリント鉱山
がーでっどらいおんとりで	ガーデッドライオン砦
きんぐすくれすとこうざん	キングスクレスト鉱山
きんぐずくれすとこうざん	キングズクレスト鉱山
くりあすぷりんぐしょうこ	クリアスプリング小湖
くれすとしぇいどこうざん	クレストシェイド鉱山
ぐるーむばうんどこうざん	グルームバウンド鉱山
ごーるでんろっくこうざん	ゴールデンロック鉱山
しゅりーくうぃんどとりで	シュリークウィンド砦
すちーむすこーちこうざん	スチームスコーチ鉱山
てんじぇるすとらんどとう	テンジェルストランド島
でぃーぷくらっぐこうざん	ディープクラッグ鉱山
とりぷるさーくるこうざん	トリプルサークル鉱山
どらごんてーるさんみゃく	ドラゴンテール山脈
どらごんているさんみゃく	ドラゴンテイル山脈
のーすうぃんどさんちょう	ノースウィンド山頂
ばっどうぉーたーこうざん	バッドウォーター鉱山
ぶろーくんたすくこうざん	ブロークンタスク鉱山
ヴぁーでんふぇるかいがん	ヴァーデンフェル海岸
ヴぁいるくらっちこうざん	ヴァイルクラッチ鉱山
あんだーすとーんとりで	アンダーストーン砦
あんどーんてっどとりで	アンドーンテッド砦
うぃんどしゅりーくはま	ウィンドシュリーク浜
うぇいくうぉーかーかい	ウェイクウォーカー海
おんしずぶれすこうざん	オンシズブレス鉱山
かーすわすてんこうざん	カースワステン鉱山
かんばーらんどこうざん	カンバーランド鉱山
きんぐずくれすととりで	キングズクレスト砦
くりぷとうぉっちとりで	クリプトウォッチ砦
ぐりーんうぉーるとりで	グリーンウォール砦
ぐれいどみすとこうざん	グレイドミスト鉱山
ぐれなでぃーんしょとう	グレナディーン諸島
こーるどろっくこうざん	コールドロック鉱山
こるすけっがーこうざん	コルスケッガー鉱山
さくすりーるきっちんけ	サクスリールキッチン家
さんどぶろうんこうざん	サンドブロウン鉱山
しゃったー・しーるどけ	シャッター・シールド家
しゅうかくかんしゃさい	収穫感謝祭
すかいすぱいあーとりで	スカイスパイアー砦
すとーむくろーくとりで	ストームクローク砦
すとーんしぇーぱーさん	ストーンシェーパー山
すとーんひるずこうざん	ストーンヒルズ鉱山
すとらいでんとかいがん	ストライデント海岸
すふぃんくすもすとりで	スフィンクスモス砦
すヴぁーるばるしょとう	スヴァールバル諸島
だーくしぇいどこうざん	ダークシェイド鉱山
だがーふぉーるかいがん	ダガーフォール海岸
とろるへったさんちょう	トロルヘッタ山頂
どらごんくろーこうざん	ドラゴンクロー鉱山
ないふぽいんとこうざん	ナイフポイント鉱山
にるんくらっつこうざん	ニルンクラッツ鉱山
のーすういんどこうざん	ノースウインド鉱山
はちゅうりょうせいるい	爬虫両生類
はんまーふぇるはんとう	ハンマーフェル半島
ふぁいあぶらんどとりで	ファイアブランド砦
ふぃっしゃーまんずとう	フィッシャーマンズ島
ふぇるはめーるこうざん	フェルハメール鉱山
ふぉーくらんどしょとう	フォークランド諸島
ふぉん・あいぐりっどけ	フォン・アイグリッド家
ふぉん・えすてぃけんけ	フォン・エスティケン家
ふぉん・えヴぇれっくけ	フォン・エヴェレック家
ふらーぐすたーととりで	フラーグスタート砦
ふろすとぶれいくとりで	フロストブレイク砦
ぶらいんどくりふとりで	ブラインドクリフ砦
ぶらっくぶーとこうざん	ブラックブート鉱山
ぶらっどめいんこうざん	ブラッドメイン鉱山
もーんほーるどこうざん	モーンホールド鉱山
もろううぃんどしょとう	モロウウィンド諸島
ろすがりあんさんみゃく	ロスガリアン山脈
ヴぇろーてぃさんみゃく	ヴェローティ山脈
あーじぇんとこうざん	アージェント鉱山
あるふたんどひょうが	アルフタンド氷河
あれすうぇるこうざん	アレスウェル鉱山
いんどらにおんとりで	インドラニオン砦
うんどうふぜんしょう	運動不全症
おりはるこんこうざん	オリハルコン鉱山
きたかぜのきとうさい	北風の祈祷祭
くいっくすてっぷさん	クイックステップ山
くろっしんぐこうざん	クロッシング鉱山
ぐらでみすとこうざん	グラデミスト鉱山
ぐりむうぉっちとりで	グリムウォッチ砦
ぐりむじゃーるとりで	グリムジャール砦
ぐれいどみすととりで	グレイドミスト砦
こーるどはーばーばし	コールドハーバー橋
こるすけぐるこうざん	コルスケグル鉱山
さぬあらっちこうざん	サヌアラッチ鉱山
さまーせっとぐんとう	サマーセット群島
さまーせっとしょとう	サマーセット諸島
しゃとぅるさんみゃく	シャトゥル山脈
しょうしゅくまじゅつ	小縮魔術
しヴぁりんぐひょうが	シヴァリング氷河
じぇらーるさんみゃく	ジェラール山脈
じゅうかんせつしょう	重関節症
すとーんひーヴぁーけ	ストーンヒーヴァー家
すとーんふぁんぐとう	ストーンファング島
すふぃんくすもすさん	スフィンクスモス山
そーらなっくこうざん	ソーラナック鉱山
だいあふろすととりで	ダイアフロスト砦
だいいちたねまきさい	第一種蒔き祭
だがーふぉーるとりで	ダガーフォール砦
だんぷほーるこうざん	ダンプホール鉱山
てるヴぁんにかいがん	テルヴァンニ海岸
てるヴぁんにはんとう	テルヴァンニ半島
とそなしゃぷこうざん	トソナシャプ鉱山
どらごんくろーとりで	ドラゴンクロー砦
どれーくろうこうざん	ドレークロウ鉱山
どれいくろうこうざん	ドレイクロウ鉱山
なんぷうのきとうさい	南風の祈祷祭
にちぼつかんしゃさい	日没感謝祭
のーすうぉっちとりで	ノースウォッチ砦
ばーくばいとこうざん	バークバイト鉱山
ばいるがるちこうざん	バイルガルチ鉱山
ひいひいひいじいさん	曾曾曾祖父さん
ひいひいひいばあさん	曾曾曾祖母さん
ふぁっらがとこうざん	ファッラガト鉱山
ふぁるとにあこうざん	ファルトニア鉱山
ふぇあゆーるこうざん	フェアユール鉱山
ふぇるはめーるとりで	フェルハメール砦
ふぉーくおりーこじま	フォークオリー小島
ふねのはかばかいがん	船の墓場海岸
ぶらっく・ぶらいあけ	ブラック・ブライア家
ぶらっくむーあとりで	ブラックムーア砦
ぶるーぶらっどとりで	ブルーブラッド砦
ぶるーろーどこうざん	ブルーロード鉱山
ほわいとふぉーるさん	ホワイトフォール山
ぼーんすとるーんさん	ボーンストルーン山
ぼーんすとれうんさん	ボーンストレウン山
まうんと・くれーるけ	マウント・クレール家
まっどつりーこうざん	マッドツリー鉱山
みすとヴぇいるとりで	ミストヴェイル砦
もるぶんすかーとりで	モルブンスカー砦
らいむうぃんどとりで	ライムウィンド砦
らぐんヴぁるどうんが	ラグンヴァルド運河
りーちうぃんどとりで	リーチウィンド砦
りっぷさんどしょうこ	リップサンド小湖
れっどべりーこうざん	レッドベリー鉱山
ろすとないふこうざん	ロストナイフ鉱山
ろっくわろうこうざん	ロックワロウ鉱山
ヴぁーでんふぇるかい	ヴァーデンフェル海
ヴぁーでんふぇるさん	ヴァーデンフェル山
ヴぁーでんふぇるとう	ヴァーデンフェル島
ヴぁるとへいむとりで	ヴァルトヘイム砦
ヴぁんでんふぇるとう	ヴァンデンフェル島
ヴぇるめんてぃーのけ	ヴェルメンティーノ家
あおいろさんみゃく	青色山脈
あすかでぃあんとう	アスカディアン島
あびしあんかいがん	アビシアン海岸
あまヴぇっととりで	アマヴェット砦
あめーるさんみゃく	アメール山脈
あらしのまじゅつし	嵐の魔術師
あれすうぇるとりで	アレスウェル砦
あれっしあこうざん	アレッシア鉱山
いちばつひゃっかい	一罰百戒
うぃんどへるむばし	ウィンドヘルム橋
うぉーでんこうざん	ウォーデン鉱山
えるどせりっくかい	エルドセリック海
おーらんどしょとう	オーランド諸島
おくせんふるとばし	オクセンフルト橋
おるしにうむとりで	オルシニウム砦
かずぐーるこうざん	カズグール鉱山
かんにんぶくろのお	堪忍袋の緒
きょぜつされしもの	拒絶されし者
くらっくたすくさん	クラックタスク山
くるーえる・しーけ	クルーエル・シー家
くるっくばっくぬま	クルックバック沼
くれないのくんしゅ	紅の君主
くヴぁるへいむとう	クヴァルヘイム島
ぐれいむーあとりで	グレイムーア砦
こいぐりんこうざん	コイグリン鉱山
こおりのまじゅつし	氷の魔術師
さーるざるこうざん	サールザル鉱山
さんるとぅーるがわ	サンルトゥール川
ざんとにうすとりで	ザントニウス砦
ししゃのしゅくさい	死者の祝祭
しじょうきょうそう	市場競争
しょうしゅくまほう	小縮魔法
しるばーぶらっどけ	シルバーブラッド家
しろがねきょうてい	白金協定
じゅんぷうまんぱん	順風満帆
すかいうぉっちとう	スカイウォッチ島
すけりっじぐんとう	スケリッジ群島
すけりっじしょとう	スケリッジ諸島
すけりっじはんとう	スケリッジ半島
すとーむくろーくけ	ストームクローク家
すとらいでんとかい	ストライデント海
すとりーむこうざん	ストリーム鉱山
すのー・しょっどけ	スノー・ショッド家
すのーほーくとりで	スノーホーク砦
ぞるぐんでこうざん	ゾルグンデ鉱山
だいにたねまきさい	第二種蒔き祭
だがーふぉーるかい	ダガーフォール海
だしゅにくこうざん	ダシュニク鉱山
だわーすとーんとう	ダワーストーン島
だんすたっどとりで	ダンスタッド砦
ちゃるまんこうざん	チャルマン鉱山
てるしょっくとりで	テルショック砦
でぃ・さるばれすけ	ディ・サルバレス家
でぃーぷまーしゅけ	ディープマーシュ家
ど・これんてぃんけ	ド・コレンティン家
どーんがーどとりで	ドーンガード砦
どぅえまーこうざん	ドゥエマー鉱山
どらごんてーるさん	ドラゴンテール山
どらごんているさん	ドラゴンテイル山
どれいくろうとりで	ドレイクロウ砦
にゅーぐらどとりで	ニューグラド砦
にるんぴすこうざん	ニルンピス鉱山
ねんおうしきてんび	年央式典日
のーすうぃんどさん	ノースウィンド山
はやぶささんみゃく	ハヤブサ山脈
はんげつのくれすと	半月のクレスト
ばーるーとこうざん	バールート鉱山
ばるけるがーどかい	バルケルガード海
ばるふぃえらとりで	バルフィエラ砦
ぱいんうぉっちさん	パインウォッチ山
ひかりのしゅくさい	光の祝祭
びすざーくこうざん	ビスザーク鉱山
びたーぽいんとはま	ビターポイント浜
ぴとけあんしょとう	ピトケアン諸島
ふぁっらがととりで	ファッラガト砦
ふぇるぐろうとりで	フェルグロウ砦
ふじゃるでぃんぐこ	フジャルディング湖
ふろすともすとりで	フロストモス砦
ぶとうかいふうしゃ	舞踏会風車
ぶりーくろっくさん	ブリークロック山
ぶりーくろっくとう	ブリークロック島
ぶりんどるこうざん	ブリンドル鉱山
ぶるーろーどとりで	ブルーロード砦
ぶろーどへっどかい	ブロードヘッド海
べあくろーこうざん	ベアクロー鉱山
ほのおのまじゅつし	炎の魔術師
まーしゃるしょとう	マーシャル諸島
まはかむさんみゃく	マハカム山脈
みすとうぉっちさん	ミストウォッチ山
めいやーずどるふけ	メイヤーズドルフ家
りーわーどしょとう	リーワード諸島
れいにるさんみゃく	レイニル山脈
れいヴんうぉっちけ	レイヴンウォッチ家
ろーべっくこうざん	ローベック鉱山
ろうすがりあんさん	ロウスガリアン山
ろすがーさんみゃく	ロスガー山脈
ヴぁるーさんみゃく	ヴァルー山脈
ヴぃーげるばっどけ	ヴィーゲルバッド家
ヴぇろしさんみゃく	ヴェロシ山脈
あーすたーなーけ	アースターナー家
あーでくろヴさん	アーデクロヴ山
あくぃらりおすけ	アクィラリオス家
あこす・かさずけ	アコス・カサズ家
あしぇんこうざん	アシェン鉱山
あっしゅこうざん	アッシュ鉱山
ありうすこうざん	アリウス鉱山
あるかいあとりで	アルカイア砦
あるたえるむとう	アルタエルム島
あん・くらいとけ	アン・クライト家
あんぜんだいいち	安全第一
あんどヴぃくとう	アンドヴィク島
あんヴぃるとりで	アンヴィル砦
いくさしょうぞく	戦装束
いるなるたとりで	イルナルタ砦
いんぐだれんとう	イングダレン島
いんぺりあるさん	インペリアル山
いんぺりあるとう	インペリアル島
うぃっちこうざん	ウィッチ鉱山
うぉーでんとりで	ウォーデン砦
うらぎられしもの	裏切られし者
えばーもあとりで	エバーモア砦
えぼんはーととう	エボンハート島
えるせりっくかい	エルセリック海
えるどべるぐとう	エルドベルグ島
おうごんかいがん	黄金海岸
おんなぞくちょう	女族長
かいこすしょとう	カイコス諸島
かすてるでしあけ	カステルデシア家
かすみのどうけつ	かすみの洞穴
かずぐーるとりで	カズグール砦
かぜのまじゅつし	風の魔術師
かばなんととりで	カバナント砦
かむろーんとりで	カムローン砦
からしゅっちょう	空出張
かんばーらんどけ	カンバーランド家
がーざぐこうざん	ガーザグ鉱山
きるくりーすさん	キルクリース山
ぎょうしょうにん	行商人
ぎょうせいのつき	暁星の月
くふらすこうざん	クフラス鉱山
くらてぃこうざん	クラティ鉱山
くりあぱいんいけ	クリアパイン池
くりのきかいがん	クリノキ海岸
くろゆりのやかた	黒百合の館
くわまーこうざん	クワマー鉱山
ぐれい・めーんけ	グレイ・メーン家
けいまんしょとう	ケイマン諸島
けんちくがいしゃ	建設会社
こうきでんりょく	光起電力
こくたんこうざん	黒檀鉱山
こっきょうとりで	国境砦
ごぶりんこうざん	ゴブリン鉱山
さぬらちこうざん	サヌラチ鉱山
さまーせっととう	サマーセット島
さんがーどとりで	サンガード砦
ざふぃるべるわん	ザフィルベル湾
しーどれいくかい	シードレイク海
しあんふぁねりけ	シアンファネリ家
しじょうあくせす	市場アクセス
しじょうけいざい	市場経済
しじょうせいさん	市場生産
しじょうせんゆう	市場占有
しじょうちょうさ	市場調査
しゅうかくのつき	収穫の月
しゅうしゅうにん	収集人	収拾人
しょうわるおんな	性悪女
しょくようあぶら	食用油
じあんかるでぃけ	ジアンカルディ家
すいこうさいばい	水耕栽培
すくぅーまぐらい	スクゥーマ喰らい
すとーむくらぐけ	ストームクラグ家
すとーんこうざん	ストーン鉱山
すとらんどとりで	ストランド砦
すとりっどぼんち	ストリッド盆地
すにどほーるとう	スニドホール島
すぴかろーぐとう	スピカローグ島
すらしあれっとう	スラシア列島
せもんどこうざん	セモンド鉱山
そうそうそうそふ	曾曾曾祖父
そうそうそうそぼ	曾曾曾祖母
そなーくこうざん	ソナーク鉱山
そるすせいむとう	ソルスセイム島
そろもんしょとう	ソロモン諸島
たーくすしょとう	タークス諸島
たきせんたくほう	多肢選択法
たるでいくとりで	タルデイク砦
だいあふろすとけ	ダイアフロスト家
だいどうげいにん	大道芸人
ちゃるまんとりで	チャルマン砦
ちょこれーとかい	チョコレート海
つーすぱいくさん	ツースパイク山
てるヴぁんにかい	テルヴァンニ海
とろるへったさん	トロルヘッタ山
どうけつとろーる	洞穴トロール
どみにおんとりで	ドミニオン砦
どりゅあだくさん	ドリュアダク山
どろっぷこうざん	ドロップ鉱山
なんちゅうのつき	南中の月
にっこうよくべや	日光浴部屋
にゅうしょくしゃ	入植者
のーふぉーくとう	ノーフォーク島
はーすとらどがわ	ハーストラド川
はいたいどとりで	ハイタイド砦
ばーじんしょとう	バージン諸島
ばとる・ぼーんけ	バトル・ボーン家
ばるふぃえらとう	バルフィエラ島
ひいひいじいさん	曾曾祖父さん
ひいひいばあさん	曾曾祖母さん
ひいひいひいじじ	曾曾曾祖父
ひいひいひいばば	曾曾曾祖母
びたーはんどさん	ビターハンド山
ふぁれりあとりで	ファレリア砦
ふぇろーしょとう	フェロー諸島
ふぉりーこうざん	フォリー鉱山
ふるへるむとりで	フルヘルム砦
ぶれしゅーるがわ	ブレシュール川
ぷりぐまんどはし	プリグマンド橋
ぷりぐまんどばし	ニベン橋
へいむりんとりで	ヘイムリン砦
べるふぁいあとう	ベルファイア島
べんきょうぶそく	勉強不足
ほうじょうのつの	豊穣の角
ぼうえきがいしゃ	貿易会社
まらばるいわやま	マラバル岩山
まりあなしょとう	マリアナ諸島
まるかるすとりで	マルカルス砦
みずのまじゅつし	水の魔術師
みはらいそうがく	未払総額
もーくるへいげん	モークル平原
もーすりんぐさん	モースリング山
もーずりんぐさん	モーズリング山
もうるのすとりで	モウルノス砦
もばーるこうざん	モバール鉱山
やおちょうじあい	八百長試合
やんまいえんとう	ヤンマイエン島
らすとぶらっどけ	ラストブラッド家
りーふしゃどうこ	リーフシャドウ湖
りびんぐるーむけ	リビングルーム家
りょくちゅうせき	緑柱石
りるヴぃえーぶけ	リルヴィエーブ家
れいるずこうざん	レイルズ鉱山
れいれすこうざん	レイレス鉱山
れっどせいるかい	レッドセイル海
れっどるーくさん	レッドルーク山
れんしゅうじあい	練習試合
れんりーじゃかい	レンリージャ海
ろーべっくとりで	ローベック砦
ろすがりあんさん	ロスガリアン山
ろふぉーてんわん	ロフォーテン湾
ヴぁる・あとれけ	ヴァル・アトレ家
ヴぁれんへいげん	ヴァレン平原
ヴぃヴぁるでぃけ	ヴィヴァルディ家
ヴぇろーてぃさん	ヴェローティ山
あすとるとりで	アストル砦
あずりあんかい	アズリアン海
あっしゅとりで	アッシュ砦
あともーらかい	アトモーラ海
あびしあんかい	アビシアン海
あみめおしだし	網目押出
あらんどとりで	アランド砦
ありうすとりで	アリウス砦
あるごにあんけ	アルゴニアン家
あるだのびあけ	アルダノビア家
あるてうむとう	アルテウム島
あるとまーかい	アルトマー海
あれっしあばし	アレッシア橋
あんそーるさん	アンソール山
あんヴぃるとう	アンヴィル島
いーぐるずはま	イーグルズ浜
いきのびしもの	生き延びし者
いくさげしょう	戦化粧
いじわるおんな	意地悪女
いやがおうでも	否が応でも
いりあっくわん	イリアック湾
いんどりーるけ	インドリール家
うぃんだまーこ	ウィンダマー湖
うぇりんがむけ	ウェリンガム家
うっさーとりで	ウッサー砦
えいようぶそく	栄養不足
えとにるとりで	エトニル砦
えらばれしもの	選ばれし者
えりのーんとう	エリノーン島
えんせいじあい	遠征試合
えヴぇれっくけ	エヴェレック家
おーりどんかい	オーリドン海
おーりどんとう	オーリドン島
おうかっしょく	黄褐色
おうちゃくもの	横着者
おおむぎばたけ	大麦畑
おせっかいもの	おせっかい者	お節介者	御節介者
おちょうしもの	お調子者
おぶらいあんけ	オブライアン家
おるぐぬむりん	オルグヌム鱗
おんがいしょう	音害症
おんこぶらがわ	オンコブラ川
かいしょくどう	海食洞
かじきかいがん	カジキ海岸
かすたぶとりで	カスタブ砦
かんきたいせい	寒気耐性
かんりにんべや	管理人部屋
がりーこうざん	ガリー鉱山
がんじょうもの	頑丈者
きゃべつばたけ	キャベツ畑
きゅうだいしん	九大神
きゅろっとばし	キュロット橋
きょうどうこう	共同溝
きょくれいとう	極冷凍
きりのどうけつ	霧の洞穴
きんりょくせき	金緑石
くっくしょとう	クック諸島
くりすますとう	クリスマス島
くれいとりーけ	クレイトリー家
くれないのとう	紅の塔
けいどうみゃく	頸動脈
けっぺきしょう	潔癖性
けんしゃくにん	献酌人
けんとうじあい	拳闘試合
げっちょうせき	月長石
こうかいじあい	公開試合
こうこんのつき	黄昏の月
こうしょうにん	交渉人
こうそうのつき	降霜の月
こうれいじゅつ	降霊術
ここすしょとう	ココス諸島
こざんせっとけ	コザンセット家
こっかっしょく	黒渇色
さいばいのつき	栽培の月
さんきせんえき	三旗戦役
さんぐりーるけ	サングリール家
しかばねぐらい	屍喰らい
しじょうかかく	市場価格	市場化
しじょうかくり	市場隔離
しじょうきんり	市場金利
しじょうげんり	市場原理
しじょうしゅぎ	市場主義
しどなこうざん	シドナ鉱山
しどはこうざん	シドハ鉱山
しゃっくるばし	シャックル橋
しゃとぅるさん	シャトゥル山
しゅうきんにん	集金人
しゅうのうべや	収納部屋
しょうしんもの	小心者
しょうじきもの	正直者
しょうどうせき	晶洞石
しょうにんさい	商人祭
しようにんべや	使用人部屋
しろがねのとう	白金の塔
しろでぃーるけ	シロディール家
しろわしとりで	白鷲砦
しんおうのつき	真央の月
しんぱいしょう	心配性
じぇらーるさん	ジェラール山
じぇんせんさん	ジェンセン山
じゃくはいもの	若輩者
じゅじょうせい	樹上性
じょうのうひん	上納品
じょろうおんな	女郎女
すかーぷとりで	スカープ砦
すくぅーまべや	スクゥーマ部屋
すくりぼにあけ	スクリボニア家
すけりっぐとう	スケリッグ島
すけりっじかい	スケリッジ海
すてぃるくとう	スティルク島
すとらいぷさん	ストライプ山
すとりっどがわ	ストリッド川	ストリッド河
すとれんがーけ	ストレンガー家
すのうぼーんけ	スノウボーン家
すらすぐんとう	スラス群島
せいそうのつき	星霜の月
せいたんきょく	聖譚曲
せいてんきゅう	星天球
せきかっしょく	赤渇色
せんけんのめい	先見の明
せんしょうしゃ	先唱者
せんじゅつかく	戦術核
せんぞだいだい	先祖代々	先祖代代
せんちねるかい	センチネル海
せんちねるはま	センチネル浜
ぜんりりとりで	ゼンリリ砦
そうじゅうかん	操縦桿
そんぞうしょう	樽造匠
たーんきすとけ	ターンキスト家
たまごこうざん	卵鉱山
たりゅうじあい	他流試合
たるらいんさん	タルライン山
たんかっしょく	淡褐色
ちゃかっしょく	茶渇色
ちゅうおうべや	中央部屋
ちゅうかいにん	仲介人
ちょうたいしゃ	超体斜
ついじゅうしゃ	追従者
つかがしらいし	柄頭石
てるしょっくけ	テルショック家
てるヴぁんにけ	テルヴァンニ家
てんぺすととう	テンペスト島
で・よんきあけ	デ・ヨンキア家
でぃしーとがわ	ディシート川
とらすたまらけ	トラスタマラ家
とろーるどわん	トロールド湾
ど・らくろわけ	ド・ラクロワ家
どみにおんかい	ドミニオン海
どれさんとりで	ドレサン砦
ないしゅっけつ	内出血
なしとげしもの	成し遂げし者
なんじゃくもの	軟弱者
なんとせいけん	南斗聖拳
にべねいぼんち	ニベネイ盆地
にまるてんさん	ニマルテン山
ねんおうのつき	年央の月
はいかっしょく	灰褐色	灰渇色
はいしゅつこう	排出口
はくじょうもの	薄情者
はくめいのつき	薄明の月
はんどこうざん	ハンド鉱山
ばえるぼーんけ	バエルボーン家
ばじょうじあい	馬上試合
ばるこにーべや	バルコニー部屋
びょるさえがわ	ビョルサエ川
ふぁーんどさん	ファーンド山
ふぁるんとりで	ファルン砦
ふぉあべあーけ	フォアベアー家
ふぉんとぼんけ	フォントボン家
ふかいのぴっく	不壊のピック
ふこころえもの	不心得者
ふなしょくにん	船職人
ふらすこうざん	フラス鉱山
ふらはーてぃけ	フラハーティ家
ふろっせるさん	フロッセル山
ふんしゅつこう	噴出口
ぶーとこうざん	ブート鉱山
ぶさいそうもの	不愛想者
ぶらにいむとう	ブラニイム島
ぶらんけっとけ	ブランケット家
ぷれいてぃんけ	プレイティン家
へるげんとりで	ヘルゲン砦
へるふりっどけ	ヘルフリッド家
べんきょうべや	勉強部屋
ぺりんげーるけ	ペリンゲール家
ぺるだしょうこ	ペルダ小湖
ほくとしんけん	北斗神拳
ほわいたーがわ	ホワイター川
ほんだわらかい	ホンダワラ海
まじゅつしかい	魔術師会
まんがくばらい	満額払	満額払い
むあんだじあい	無安打試合
めんざいじあい	免罪試合
もてぃえーるけ	モティエール家
やみのいっとう	闇の一党
よみがえりのひ	黄泉返りの日
よるぐりむがわ	ヨルグリム川
らいむぎばたけ	ライ麦畑
らいらっくわん	ライラック湾
らるしうすがわ	ラルシウス川
りふてんとりで	リフテン砦
りゅうこんそう	竜根草
りゅうさんだん	榴散弾
れいふうがぶち	冷風ヶ淵
れいれすとりで	レイレス砦
れっどさんさん	レッドサン山
ろーんふぁるけ	ローンファル家
ろうぼくのした	老木の下
ろっくこうざん	ロック鉱山
ヴぁらぼるだけ	ヴァラボルダ家
ヴぃらくとりで	ヴィラク砦
ヴぇらんとぬま	ヴェラント沼
ヴぇりえれすけ	ヴェリエレス家
ヴぇるもんとけ	ヴェルモント家
ヴぉるじゃーけ	ヴォルジャー家
あいべあとう	アイベア島
あしでまとい	足手まとい
あだなすもの	仇なす者
あだりあわん	アダリア湾
あとにむーけ	アトニムー家
あとひまーけ	アトヒマー家
あばなしーけ	アバナシー家
あめーるさん	アメール山
あもるとりで	アモル砦
あゆみしもの	歩みし者
あるじなきち	主無き地
あるふぁせん	アルファ線
あれてぃのけ	アレティノ家
あんくらすけ	アンクラス家
あんないにん	案内人
いくさおとめ	戦乙女
いたずらもの	いたずら者	悪戯者
いちもんなし	一文なし	一文無し
いのーるとけ	イノールト家
いやしむべき	卑しむべき
いらずらぐせ	いたずら癖
いりなるたこ	イリナルタ湖
いろこいざた	色恋沙汰
いんしゅうし	隠修士
いんだれんけ	インダレン家
いんどりるけ	インドリル家
うけとりにん	受取人
うすらわらい	薄ら笑い
うっかりもの	うっかり者
うらぎりもの	裏切者
うりあらとう	ウリアラ島
えいへいべや	衛兵部屋
えっざくさん	エッザク山
えどらるどけ	エドラルド家
えむかいとう	エムカイ島
えりのーんけ	エリノーン家
えんこうせき	塩鉱石
えんすいずけ	塩水漬
おうせつべや	応接部屋
おうどういろ	黄銅色
おおいちばん	大一番
おおおくさま	大奥様
おおざけのみ	大酒飲み
おおばかもの	大馬鹿者
おおよろこび	大喜び
おじょうさん	御嬢さん
おねしょぐせ	おねしょ癖
おやかたさま	御館様	お館様	お館さま	御屋形様	お屋形様	お屋形さま
おんぼろせん	おんぼろ船	オンボロ船
おんぼろぶね	おんぼろ舟	オンボロ舟
かーぼんさん	カーボン山
かいぞえにん	介添人	介添え人
かいほうせき	海泡石
かえんきゅう	火炎球
かしみーるけ	カシミール家
かたながしら	刀頭
かなきりどり	金切鳥	金切り鳥
からやくそく	空約束
かるこりすけ	カルコリス家
かんきんべや	監禁部屋
かんむりいし	冠石
がーじぇすけ	ガージェス家
がーどなーけ	ガードナー家
がくいんじま	学院島
がらくたさん	ガラクタ山
きこえしもの	聞こえし者
きゅうじにん	給仕人
きゅうせいき	吸精鬼
きゅうぞうき	吸臓鬼
きょうけつき	狂血鬼
きらわれもの	嫌われ者
きんべんもの	勤勉者
ぎゃらりーけ	ギャラリー家
くおーつさん	クオーツ山
くちばのもり	朽葉の森
くりのきかい	クリノキ海
くれーんとう	クレーン島
くろっくとう	クロック島
ぐいまーどけ	グイマード家
ぐっどまんけ	グッドマン家
ぐんようけん	軍用犬
けいうのつき	恵雨の月
けしりーとう	ケシリー島
けっせいせき	血星石
けなーしとう	ケナーシ島
げんそうつう	幻想痛
こうぎょうゆ	工業油
こっせつねつ	骨折熱
こむぎばたけ	小麦畑
ごーるどとう	ゴールド島
ごうつくばり	業突く張り
ごうもんじま	拷問島
ごうもんべや	拷問部屋
ごぜんじあい	御前試合
ごるごんさん	ゴルゴン山
さいだんべや	祭壇部屋
さいばいべや	栽培部屋
さきぼそいし	先細石
さぎょうべや	作業部屋
さすらいびと	さすらい人	流離人
さすらいもの	さすらい者	流離者
さつぎゅうき	殺牛鬼
さねっどとう	サネッド島
さぼるでぃけ	サボルディ家
さまよいびと	彷徨い人	彷徨人
さまようもの	さまよう者	彷徨う者
さるばれすけ	サルバレス家
さんでぃるけ	サンディル家
ざいろーがわ	ザイロー川
しあわせもの	幸せ者
しじょうかち	市場価値
しじょうがた	市場型
したいあさり	死体漁り
したかんぱん	下甲板
しなんのわざ	至難の業
しゃがんたい	遮眼帯
しゃむろんけ	シャムロン家
しゅうどうし	修道士
しゅえいべや	守衛部屋
しゅすいこう	取水口
しょういだん	焼夷弾
しょくじべや	食事部屋
しょけいにん	処刑人
しょヴりーけ	ショヴリー家
しらたるとう	シラタル島
しろのやしろ	白の社
しんざんもの	新参者
しんじゅかい	真珠海
しんせいさい	新生祭
しんせつもの	親切者
じーるとりで	ジール砦
じしゅのつき	蒔種の月
じゅじゅつし	呪術師
じゅんくすけ	ジュンクス家
じょーんずけ	ジョーンズ家
じょうきべや	蒸気部屋
じょうきょう	上胸
じょさいどう	除細動
すいみんべや	睡眠部屋
すずこうざん	スズ鉱山
すてんりくけ	ステンリク家
すぱいくさん	スパイク山
すぱいとさん	スパイト山
すみやきにん	炭焼人
せいあるもの	生ある者
せいけつずき	清潔好き
せいさくべや	製作部屋	制作部屋
せいさんべや	生産部屋
せいすいびん	聖水瓶
せいどういろ	青銅色
せいどうじま	聖堂島
せいどうばし	聖堂橋
せいひじゅつ	声秘術
せいめいのわ	生命の環
せかいきゅう	世界球
せぷてぃむけ	セプティム家
せんたくにん	洗濯人
せんたくもの	洗濯物
せヴぇりんけ	セヴェリン家
ぜれんとりで	ゼレン砦
そうそうそふ	曾曾祖父
そうそうそぼ	曾曾祖母
そうぞうしゅ	創造主
そうぞくにん	相続人
たいくつもの	退屈者
たいんとりで	タイン砦
たきぎのつき	薪木の月
たきせんたく	多肢選択
たちあいにん	立会人
たんさくこう	探索行
だいしんでん	大神殿
だいたいこつ	大腿骨
だいりつせき	大立石
だんざいにん	断罪人
ちげんびょう	知減病
ちゅうちょう	抽腸
ちょうきゅう	長弓
ちょうじょう	超常
ちょうりべや	調理部屋
ついついしん	追々伸
つたえしもの	伝えし者
つののかぶと	角の兜
てぃっせんけ	ティッセン家
ていたんさい	帝誕祭
ていてつじま	蹄鉄島
ておしぐるま	手押車
てるヴぁにけ	テルヴァニ家
てんせいせき	天青石
でぃれいんけ	ディレイン家
でぃれんがわ	ディレン川
とうぎじあい	闘技試合
とこあしらい	床あしらい
とこじょうず	床上手
とむらいざけ	弔い酒
どぅるーぬま	ドゥルー沼
どうぶつずき	動物好き
どすりえるけ	ドスリエル家
どりょうこう	度量衡
なぐさみもの	慰み者
にーびりーけ	ニービリー家
にゅーすべや	ニュース部屋
にょるどかい	ニョルド海
ねほりはほり	根堀り葉堀り
ねんだいもの	年代物
のうしんとう	脳振とう	脳振盪
はいいろちく	灰色地区
はいたつにん	配達人
はかほりにん	墓堀人	墓堀り人
はくひしょう	白皮症
はさみじゃく	はさみ尺
はちだいしん	八大神
はみだしもの	はみ出し者
はやぶささん	ハヤブサ山
はるしおんこ	ハルシオン湖
ばれんしあけ	バレンシア家
ばれんじあけ	バレンジア家
ばんにんべや	番人部屋
ばんれいさい	万霊祭
ぱくととりで	パクト砦
ひいひいじじ	曾曾祖父
ひいひいばば	曾曾祖母
ひかりちいき	光地域
ひきうけにん	引受人
ひきょうもの	卑怯者	ひきょう者	卑きょう者
ひとしょうぶ	一勝負
ひねくれもの	ひねくれ者
ひょうしょう	標章
ひんだーとう	ヒンダー島
びえにーなけ	ビエニーナ家
びたいちもん	ビタ一文	鐚一文
びょうきざみ	秒刻み
びょるさえこ	ビョルサエ湖
びらるどとう	ビラルド島
びりじあんこ	ビリジアン湖
ふぁいくとう	ファイク島
ふぁにーがわ	ファニー川
ふぁらーるけ	ファラール家
ふぇろーとう	フェロー島
ふとどきもの	不届き者
ふのうびょう	腐脳病
ふらやのその	フラヤの園
ぶさほうもの	無作法者
ぶしょうもの	無精者	不精者
ぶれとんかい	ブレトン海
ぷらせだわん	プラセダ湾
ぷれすりーけ	プレスリー家
へんくつもの	偏屈者
べとにーとう	ベトニー島
べとにいとう	ベトニイ島
べとにくとう	ベトニク島
べるろーずけ	ベルローズ家
ほーかーとう	ホーカー島
ほーむとりで	ホーム砦
ほうとうもの	放蕩者
ほうどうべや	報道部屋
ほわいとがわ	ホワイト川
ほんりっちこ	ホンリッチ湖
ほんりっひこ	ホンリッヒ湖
ぼるそでぃけ	ボルソディ家
ぽんたーがわ	ポンター川	ポンター河
まぎあとりで	マギア砦
まくどなうけ	マクドナウ家
まごころのひ	真心の日
まはかむさん	マハカム山
まもりしもの	守りし者
まるこっとけ	マルコット家
みかづきがわ	三日月川
みぎあしいわ	右足岩
みくろんとう	ミクロン島
みじゅくもの	未熟者
みずさいばい	水栽培
みずだめーじ	水ダメージ
みずばくはつ	水爆発
みずひんしつ	水品質
みとどけにん	見届け人	見届人
みはらいがく	未払額
むかしむかし	昔々
めだまじあい	目玉試合
ものおきべや	物置部屋
もんくれあけ	モンクレア家
やけどしそう	火傷しそう
やっかいもの	厄介者	やっかい者
やねうらべや	屋根裏部屋
やまねこさん	ヤマネコ山
やるーががわ	ヤルーガ川	ヤルーガ河
やるこうざん	ヤル鉱山
ゆうへいべや	幽閉部屋
ゆめおいびと	夢追い人	夢追人
よせんじあい	予選試合
よるぐりむこ	ヨルグリム湖
よろいしょう	鎧匠
らなるだいけ	ラナルダ池
らりあーとけ	ラリアート家
らんぼうもの	乱暴者
らヴぁれすけ	ラヴァレス家
りすまっとけ	リスマット家
りょうりにん	料理人
りょくちゅう	緑柱
るるするぶけ	ルルスルブ家
れいにるさん	レイニル山
れっどらんけ	レッドラン家
れんきんべや	錬金部屋
れんとうしょ	連祷書
ろすがーさん	ロスガー山
ヴぁるーさん	ヴァルー山
ヴぃれいんけ	ヴィレイン家
ヴぇろしさん	ヴェロシ山
ヴぬーらとう	ヴヌーラ島
あかあかと	赤々と
あかんぼく	亜灌木
あそびべや	遊び部屋
あばれもの	暴れ者
あむれんけ	アムレン家
あめるさん	アメル山
あやつりて	操り手
あらーのけ	アラーノ家
ありあすこ	アリアス湖
ありうすこ	アリウス湖
あるじさま	主様
あるじなき	主無き
あるばがわ	アルバ河
いーぶすけ	イーブス家
いーべすけ	イーベス家	イーべス家
いえでにん	家出人
いさかいめ	諍い女
いたみどめ	痛み止め
いちばせん	市場銭
いちやそう	一夜草
いなかもの	田舎者
いんじゅつ	隠術
いんちょう	引張
いんりょく	印力
いヴぇすけ	イヴェス家
うぃろーじ	ウィロー路
うけわたし	受渡
うしろあし	後脚
うしろだて	後ろ盾
うたいびと	歌い人
うつけもの	うつけ者	空け者
うわきもの	浮気者
うわぐすり	釉薬
えーむずけ	エームズ家
えきびょう	疫病
えっきょう	越橋
えんじゅう	園中
えんじゅつ	炎術
おーるさん	オール山
おうようび	央耀日
おおあばれ	大暴れ
おおかぶと	大兜
おおだんな	大旦那
おおひろば	大広場
おおまぬけ	大間抜け
おしぐるま	押車
おすりすけ	オスリス家
おせっかい	御節介
おのがしら	斧頭
おまりーけ	オマリー家
おめしもの	御召し物
おるすわん	オルス湾
かーすがわ	カース川	カース河
かいじょう	開錠
かえりんけ	カエリン家
かがっこつ	下顎骨
かぎじょう	鉤状
かくしあじ	隠し味
かくしべや	隠し部屋
かくりべや	隔離部屋
かくれべや	隠れ部屋
かけじあい	賭け試合
かこうせき	花崗石
かじきかい	カジキ海
かじだめし	舵試し
かたりぐさ	語り草
かたんせい	可鍛性
かちくべや	家畜部屋
かっしょく	渇色
かぬらすこ	カヌラス湖
かぬるすこ	カヌルス湖
かねばらい	金払い
かぼっとけ	カボット家
かもつべや	貨物部屋
かもらんけ	カモラン家
からふじゅ	空付呪
かんしにん	監視人
かんたいじ	簡体字
かんちがい	勘違
かんちょう	灌腸
かんぶつえ	灌仏会
かんりにん	管理人
がさつもの	がさつ者
がんこもの	頑固者
がんません	ベータ線
きししゃく	騎士爵
きっちんけ	キッチン家
きとうべや	祈祷部屋
きのこぐも	キノコ雲	きのこ雲	茸雲
きばんがん	基盤岩
きゅうあく	吸握
きゅうえん	休園	旧園
きゅうかい	九戒
きゅうげき	急撃
きゅうせい	吸精	仇成
きゅうぞう	吸臓
きゅうねつ	吸熱
きょうかく	鋏角
きょうげき	強撃
きょうしゃ	怯者
きょうせい	強勢
きょうぞう	鏡像
きょうろう	協働
きょにゅう	巨乳
きよきもの	清き者
きれいずき	きれい好き	キレイ好き	綺麗好き
きんどけい	金時計
きんようび	金耀日
きんりょく	金緑
ぎまーるけ	ギマール家
ぎょうかい	凝灰
ぎろーどけ	ギロード家
ぎんどけい	銀時計
くーざんけ	クーザン家
くすりだな	薬棚
くちぜんぶ	口前部
くらいとけ	クライト家
くるーぷけ	クループ家
くるまざき	車裂き
くろぐろと	黒々と	黒黒と
けつみゃく	血脈
けんしゃく	献酌
げつようび	月耀日
こうきでん	光起電
こうじょう	攻城
こがねいろ	黄金色
こじんべや	個人部屋
こはくいろ	琥珀色
こばくだん	枯爆弾
こぼっとこ	コボット湖
こまりもの	困り者
こもりうた	子守歌	子守り歌	子守唄	子守り唄
ころなちこ	コロナチ湖
こんちゅう	こん虫
ごーんとう	ゴーン島
ごぼうせい	五芒星
ごりにるけ	ゴリニル家
ごるんとう	ゴルン島
さいくべや	細工部屋
ささげもの	捧げ物
さつじんき	殺人鬼
さらしもの	晒し者
さんちょう	山頂
ざいろがわ	ザイロ川
しかめつら	しかめ面
しごとべや	仕事部屋
しせいじょ	至聖所
しせきえい	紫石英
しっせんけ	シッセン家
しっちょう	失聴
しつじべや	執事部屋
しとつこん	刺突痕
しまつにん	始末人
しゃしょう	斜檣
しゃれもの	洒落者
しゅじょう	酒醸
しゅちゅう	主柱
しょうかん	娼館
しょうごん	聖言
しょうせき	晶石
しょうどう	晶洞
しょうめい	召命
しょうやく	生薬
しょうらい	招雷
しょうろう	娼楼
しょくざい	しょく罪
しらじらと	白々と	白白と
しんしゅう	侵襲
しんぴかい	審秘会
じゃまもの	邪魔者
じゃろるけ	ジャロル家
じゅうじん	獣人
じゅうそう	重装
じゅうりん	蹂りん
じゅじょう	樹上
じょうおう	女王
じょうかい	上階
じょうしゃ	定者
じらいげん	地雷原
すいじゅつ	水術
すうしゅん	数瞬
すみびやき	炭火焼
せいいぶつ	聖遺物
せいがいふ	聖骸布
せいじゅう	聖獣
せいちょう	聖寵
せいちょく	聖勅
せこつばこ	聖骨箱
せもんどけ	セモンド家
せんしさい	戦士祭
ぜいかんり	税関吏
そーんさん	ソーン山
そうがじゃ	双牙蛇
そうじにん	掃除人
そくけいき	測径器
そこつもの	そこつ者	粗こつ者	粗忽者
たからべや	宝部屋
たたかいて	戦い手
たまごべや	卵部屋
たむりすけ	タムリス家
たんきゅう	短弓
だいさいし	大祭司
だいしさい	大司祭
だちゅーけ	ダチュー家
ちくぎゅう	畜牛
ちゅうくう	中空
ちゅうそう	中装
ちょうだん	跳弾
ちょくれい	勅令
つうきこう	通気口
つきざとう	月砂糖
つちがしら	鎚頭
つのかぶと	角兜
つよきもの	強き者
てあらもの	手荒者
でぃえるけ	ディエル家
でぃれにけ	ディレニ家
とかいもの	都会者
とげしもの	遂げし者
とどけもの	届物	届け物
とぱるかい	トパル海
とぱるとう	トパル島
とぱるわん	トパル湾
とらめいし	虎目石
とりせらけ	トリセラ家
どーれすけ	ドーレス家
どぅーあけ	ドゥーア家
どうけのひ	道化の日
どうけもの	道化者
どられんけ	ドラレン家
どれいべや	奴隷部屋
ながれもの	流れ者
なまけぐせ	なまけ癖	怠け癖
なまりいろ	鉛色
ならがすけ	ナラガス家
なるしすこ	ナルシス湖
なヴぁとう	ナヴァ島
にちようび	日耀日
にぶんほう	二分法
にべんいけ	ニベン池
にべんがわ	ニベン川	ニベン河
にべんわん	ニベン湾
にもつべや	荷物部屋
にんきもの	人気者
のこぎりば	鋸刃
はーどとう	ハード島
はくじつむ	白日夢
はぐれぐも	浮浪雲
はぐれもの	はぐれ者
はっつさん	ハッツ山
はんたいじ	繁体字
ばくじゅう	麦汁
ばくにゅう	爆乳
ばりおんけ	バリオン家
ひきぐさり	引き鎖
ひしゃかい	被写界
ひだりうで	左腕
ひだりばね	左羽
ひとしばい	一芝居
ひとりべや	一人部屋
ひみつべや	秘密部屋
ひゃっかい	百戒
ひょうけん	氷拳
ひょうせき	氷石
ひょうぞう	氷像
ひよわもの	ひ弱者
ひんにゅう	貧乳
ふじゅべや	付呪部屋
ふとうざい	不凍剤
ふゆごもり	冬籠り
ふらーるけ	フラール家
ふらーるこ	フラール湖
ふるきもの	古き者
ふんきざみ	分刻み
ぶいんがわ	ブイン河
ぶこつもの	無骨物	武骨者	無骨者
ぶすいもの	無粋者
ぶらんくけ	ブランク家
ぶれいもの	無礼者
ぶれとんけ	ブレトン家
ぶれながわ	ブレナ川	ブレナ河
へどらんけ	ヘドラン家
へるねかい	ヘルネ海
べーたせん	ガンマ線
べいかーけ	ベイカー家
ぺっとずき	ペット好き
ほかんだな	保管棚
ほくちがね	火口金
ほくちばこ	火口箱
ほこらしげ	誇らし気
ほんにすこ	ホンニス湖
ぼりうすけ	ボリウス家
まじそんけ	マジソン家
まじゅつし	魔術師
まじょさい	魔女祭
まぬけずら	間抜け面	まぬけ面	マヌケ面
まぬけもの	まぬけ者	間抜け者
まらぴがわ	マラピ川
まるたごや	丸太小屋
まんとーけ	マントー家
みずしょり	水処理
みずのみば	水飲み場
みずまほう	水魔法
みちしるべ	道標
みちびきて	導き手
みどりいろ	緑色
みみずばれ	みみず腫れ	ミミズ腫れ	蚯蚓腫れ	みみず脹れ	ミミズ脹れ
みらーずこ	ミラーズ湖
むしのおう	蟲の王
もくようび	木耀日
やかたもの	屋形者	館者
やねがわら	屋根瓦
やみいちば	闇市場
やりつかい	槍使い
やんしーけ	ヤンシー家
ゆうぎべや	遊戯部屋
ゆみつかい	弓使い
ゆめみびと	夢見人
ようかべん	陽花弁
ようきゅう	妖蟲
よげんしゃ	預言者
よびしもの	呼びし者
よみがえり	黄泉返り
よろいいし	鎧石
よろいした	鎧下
よわきもの	弱き者
らーしむけ	ラーシム家
らいじゅつ	雷術
らいりすけ	ライリス家
らんせるけ	ランセル家
りあどんけ	リアドン家
りねはんけ	リネハン家
りびんぐけ	リビング家
りふとさん	リフト山
りゅうがん	龍眼
りゅうそく	流束
りゅうりん	竜鱗	龍鱗
るまーれこ	ルマーレ湖
るろうもの	流浪者
れいきゅう	霊弓
れいじゅつ	冷術
れどらんけ	レドラン家
ろうじょう	籠城
ろされんけ	ロサレン家
ろみりーけ	ロミリー家
わらいもの	笑い者
わるだくみ	悪だくみ
わんきょく	弯曲
ヴぁんぬけ	ヴァンヌ家
ヴぃえんけ	ヴィエン家
ヴぉれくけ	ヴォレク家
ヴりーどこ	ヴリード湖
あーるけ	アール家
あかいし	赤石
あきべや	空部屋	空き部屋
あしこう	足甲
あだうち	仇討ち
あっぱん	圧板
あつでん	圧電
あにぎみ	兄君
あにじゃ	兄者
あねぎみ	姉君
あねじゃ	姉者
あほうま	あほ馬	アホ馬	阿呆馬
あまいろ	亜麻色
あまぐつ	雨靴
あまやこ	アマヤ湖
ありづか	アリ塚
あるきて	歩き手
いきざま	生き様
いしうお	石魚
いしちく	石地区
いだてん	韋駄天
いぬごや	犬小屋
いぬずき	犬好き
いぬぶえ	犬笛
いのーけ	イノー家
いのりて	祈り手
いぶつし	遺物師
いやして	癒し手	癒手	癒やし手
いらいら	苛々	苛苛
いれずみ	刺青
いわいて	祝い手
いんせき	印石	隕石
いんてつ	隕鉄
いんのう	陰嚢
うあさん	ウア山
うきぼり	浮彫り
うじむし	ウジ虫
うみたて	産み立て
うらべや	裏部屋
うれんけ	ウレン家
えだづの	枝角
えついき	越閾
えるでけ	エルデ家
えんかん	円環
えんしゃ	園舎
えんしゅ	園主
えんせき	炎石
えんたん	炎鍛
えんだい	演台	園代
えんてい	園庭
えんゆう	園囿	苑囿
えんりん	園林
おいおい	追々
おいはぎ	追剥ぎ
おうしょ	凹所
おうたい	応対
おうよう	央耀
おおあれ	大荒れ
おおがま	大釜	大ガマ
おおぐい	大食い
おおざけ	大酒
おおぜい	大勢
おおばか	大馬鹿	大バカ
おおゆれ	大揺れ
おくりて	贈り手	送り手
おじゃま	御邪魔
おすうま	雄馬	牡馬
おそれげ	怖れげ
おだやか	穏か
おとしど	落とし戸	落戸	落し戸
おどりて	踊り手
おびてつ	帯鉄
かいえん	灰塩
かいじゅ	解呪
かいそう	壊走
かいたん	海探
かきこみ	書込
かぎあけ	鍵開け
かぎあし	鉤足
かぎがた	鉤型
かぎざお	鉤竿
かぎづめ	鉤爪	かぎ爪	カギ爪
かぎばり	鉤針
かぎゃく	加虐
かくえん	各園
かくしど	隠し戸	隠戸
かくせい	確性
かくはん	攪拌	撹拌
かしべや	貸し部屋	貸部屋
かじづか	舵柄
かせぎて	稼ぎ手
かぜちく	風地区
かそうば	火葬場
かたくな	頑な
かたりべ	語り部
かつらく	滑落
かながた	金型
かなしげ	悲し気	悲しげ
かなどこ	金床
かねぐら	金蔵
かのもの	彼の者
かみがみ	神々
かようび	火耀日
かわはぎ	皮剥ぎ
かんあつ	感圧
かんおう	陥凹
かんがい	灌漑	灌がい	潅がい
かんこつ	寛骨
かんしゃ	館舎
かんすい	灌水
かんぞう	館蔵
かんたい	簡体
かんだい	館代
かんぬき	閂	貫木
かんぶつ	灌仏
かんぼく	灌木
がいかく	外殻
がいしゃ	会社
きのした	木の下
きゃくぶ	脚部
きゅうし	仇視
きゅうま	吸魔
きょあく	巨悪
きょうぼ	教母
きょせき	巨石
きょぞう	巨像
きょれき	巨礫
きんじて	禁じ手
きんよう	金耀
ぎしまい	義姉妹
ぎしゅう	擬臭
ぎょぐん	魚群
ぎょじん	魚人
ぎんばん	銀板
くいさく	杭柵
くうしつ	空室
くぐつし	傀儡師
くだきて	砕き手
くつぞこ	靴底
くもちく	雲地区
くるしげ	苦し気	苦しげ
けいけつ	経血
けいこつ	頸骨
けいはい	傾敗	傾廃
けがにん	怪我人
けつじゅ	血呪
けつぞう	結像
けつのう	血嚢
けんがん	献眼
けんきん	献芹
けんげき	剣撃
けんざん	献残
けんしゅ	献酒
けんしん	献進
けんじゅ	献寿
けんせい	剣星	剣聖	拳聖
けんせん	献饌
けんそう	献奏
けんたい	献替
けんちゃ	献茶
けんどう	献堂
げいにく	鯨肉
げきてつ	撃鉄
げちゅう	夏中
げつよう	月耀
こあくま	小悪魔	子悪魔
こうかつ	口渇
こうくつ	後屈
こうこう	鉱坑
こうこつ	こう惚
こうだい	構台
こうれい	降霊
こぎつね	仔狐	子狐
こぎぶね	こぎ舟	こぎ船	漕船	漕舟
こげいろ	焦色	焦げ色
こしぬけ	腰抜
こしばい	小芝居
こそどろ	コソ泥
こだぬき	仔狸	子狸
こっさく	骨削
こつつぼ	骨壺
ころして	殺し手
こんせき	魂石
こんばく	魂縛
ごうえん	号園
ごみさん	ゴミ山
さいたん	再誕
さかびん	酒瓶
さがして	探し手
さけびて	叫び手
さばきて	裁き手
さりぎわ	去り際
さるむけ	サルム家
さるんけ	サルン家
さんえん	酸鉛	酸塩
さんぺい	散兵
ざんがい	残がい
ざんげき	斬撃
ししぐも	獅子蜘蛛
しじばり	支持梁
しちゃく	試着
しつあつ	室圧
しばらく	暫らく
しゃがん	遮眼
しゅこん	主根
しょうい	焼夷
しょうか	頌歌
しょうこ	小湖	礁湖
しょげき	初撃
しらかば	白樺
しらじら	白々
しんえん	新園
しんおう	真央
しんせい	親征
じーるけ	ジール家
じかすい	耳下垂
じっかい	十戒
じまんげ	自慢気	自慢げ
じゃくや	寂夜
じゅうし	従士
じゅうと	従徒
じゅけい	樹形
じょこう	女公	女皇
じょせん	除染
じょてい	女帝
じんろう	人狼
すーだけ	スーダ家
すいこう	水耕
すいしん	水浸
すきもの	好き者
すくいて	救い手
すずいし	錫石
すてふだ	捨札	捨て札
すみすけ	スミス家
せいおん	静音
せいけつ	聖血
せいこつ	聖骨
せいこん	聖痕
せいさん	聖蚕
せいせつ	聖節
せいせん	聖遷
せいぜい	精々
せいぞう	聖像
せいたん	聖誕	聖譚
せいだん	聖壇
せいはい	聖杯
せいひつ	聖櫃
せいべつ	聖別
せいめい	聖明
せきだん	石弾
せっこう	斥侯
せろすけ	セロス家
せんかい	旋廻
せんがい	船外
せんこん	戦棍
せんそう	船倉
せんつい	戦鎚	戦槌
せんみつ	繊密
ぜんえん	全園
ぜんくつ	前屈
ぜんけい	前傾
そうしゃ	操者
そうやく	草薬
そのかみ	園神
たいこう	耐航
たこべや	たこ部屋	タコ部屋	蛸部屋
たねまき	種蒔き
たのしげ	楽し気	楽しげ
たまりば	溜場
たんせい	鍛性
たんせつ	鍛接
だごすけ	ダゴス家
だんたい	弾帯
だんれつ	断裂
ちくさつ	畜殺
ちくのう	畜農
ちちぎみ	父君
ちぼしん	地母神
ちょうは	調波
ちょうひ	跳飛
ちょそう	貯槽
ちようび	地耀日
ちんでい	沈泥
つくりて	作り手	創り手	造り手
つなぎて	繋ぎ手
つみいし	積み石
つむぎて	紡ぎ手	紡手
ていせい	定星
てきかく	適確
てっこう	鉄甲	徹甲
てっせん	撤饌
とういん	踏韻
とうえん	当園
とうぞう	頭像
とうらく	頭絡
とつえん	突縁
とつがん	突岩
ともども	共々
とりこう	鳥公
どういろ	銅色
どうえん	同園
どうけつ	洞穴
どうせい	導性
どくのう	毒嚢
どくばり	毒針
どらんけ	ドラン家
どれすけ	ドレス家
どれるけ	ドレル家
どろぶね	泥船	泥舟	どろ船	どろ舟	ドロ船	ドロ舟
ないない	内々	内内
なおして	治し手	直し手
なかなか	中々	中中
ながおし	長押し
なしかけ	ナシカ家
なぞなぞ	謎々
なになに	何々
なまにく	生肉
なみなみ	波々
なんでい	軟泥
にいさま	兄様	兄さま
にぎりて	握り手
にくかい	肉塊
にちよう	日耀
にばしゃ	荷馬車
にべんけ	ニベン家
にょほう	女峰
ぬすっと	盗人
ぬりんけ	ヌリン家
ねえさま	姉さま	姉様
ねこずき	猫好き
ねんせい	燃性
ねんもの	年物
のうとう	納刀
のぼりて	登り手
はいそん	廃村
はくえん	白炎
はくげい	白鯨
はくへん	剥片
はくろう	白狼
はくろく	白鹿
はぐぬま	ハグ沼
はこびて	運び手
はしりて	走り手
はじょう	破城
はなばな	花々
ははぎみ	母君
はるかに	遙かに
はんがん	斑岩
はんせき	斑石
はんたい	繁体
ばかうま	ばか馬	バカ馬	馬鹿馬
ばかもの	馬鹿者	バカ者	大バカ者	ばか者	大ばか者
ばくあつ	爆圧
ばくさん	爆散
ばくそう	爆走
ばっこん	抜根
ばんざい	万歳
ばんせい	蛮性
ひげそり	髭剃り
ひつめつ	必滅
ひにょう	泌尿
ひみつり	秘密裡	秘密裏
ひょうろ	氷炉
びにゅう	微乳	美乳
ふうしゃ	風車
ふきかえ	吹替
ふきこみ	吹込
ふくかん	副官
ふくつう	腹痛
ふくよか	膨よか	脹よか
ふみこみ	踏込
ふんせき	噴石
ぶんえん	分園
へいえん	閉園
へいしょ	閉所
へいわり	平和裏
へらんけ	ヘラン家
べつえん	別園
ほうこう	咆吼
ほうじゅ	宝珠
ほうらん	抱卵
ほしぼし	星々
ほねぼね	骨々
ほんえん	本園
ぼうまん	膨満
ぼすべや	ボス部屋
ぼっけん	木剣
ぼろぶね	ぼろ船	ボロ船	ぼろ舟	ボロ舟
まえあし	前脚
まかぴこ	マカピ湖
まちがい	間違
まちまち	町々	街々
まなびて	学び手
まんとう	マン島
みぎうで	右腕
みぎばね	右羽
みせみせ	店々
みちみち	道々
むぞうさ	無造作
むびゅう	無謬
むらむら	村々
めぎつね	女狐
めすうま	雌馬	牝馬
めんどり	雌鶏
もいるけ	モイル家
もくよう	木耀
もどして	戻し手
もりびと	守り人
やくさい	厄災
やすざけ	安酒
やすやす	易々
やせがた	痩形
やどぬし	宿主
ゆうせい	雄性
ゆうたい	幽体
ゆかいた	床板
ゆきちく	雪地区
ようけん	妖犬
ようこう	溶鉱
ようてつ	溶鉄
ようどう	揺動
ようにく	羊肉
ようれん	溶錬
よたもの	よた者
よみこみ	読込
よみとり	読取
よりしろ	依代
らいえん	来園
らいぎん	雷銀
らいせき	雷石
らんこう	乱交
らんのう	卵のう
りゅうろ	流路
るごすけ	ルゴス家
れいけん	霊見
れいげき	冷撃
れきせい	歴青
れんきん	錬金
れんげき	連撃
れんとう	連祷
ろしょう	炉床
ろんぐけ	ロング家
わいせつ	猥せつ
わざもの	ワザ物
あさり	漁り
あみて	編み手
ありか	在り処
あんし	暗視
いそん	遺存
いちば	市場
いちみ	一味
いのう	胃嚢
いはい	遺灰
いろみ	色味
うーけ	ウー家
うかく	羽角
うらけ	裏毛
えさば	餌場	えさ場	エサ場
えんぼ	園圃
おきば	置場
おじか	雄鹿	牡鹿
おそれ	怖れ
おもり	錘
おりて	織り手	織手
かあつ	加圧
かいど	灰土
かいね	買い値
かかい	下階
かきて	描き手
かじば	鍛冶場
かじや	鍛冶屋
かたき	仇
かよう	火耀
かりて	刈り手	狩り手
かれい	加齢
かんし	鉗子
かんな	鉋
がふん	牙粉
きえん	帰園
きせき	貴石
きせん	貴賤
きどく	既読
くまで	くま手	クマ手
けいう	恵雨
けつげ	ケツ毛
けもの	獣
げせん	下賤
げっし	げっ歯	齧歯
こうひ	公妃
こうま	子馬
こうや	荒野
こおに	子鬼	小鬼
こぐま	仔熊	子熊
こじか	仔鹿	子鹿
こたび	此度
こなた	此方
こぶね	小船	小舟
こべや	小部屋
こぼく	古木
こんい	婚戚
ごぎて	漕ぎ手
ごしゃ	誤射
ごのみ	好み
ごみん	護民
さいと	催吐
さいど	彩度
させき	砂石
しこつ	趾骨
しさく	支索
しせい	雌性
しせき	紫石
しとつ	刺突
しにく	屍肉
しょく	蝕
しれつ	歯列
じしゃ	待者
じっさ	実査
じゅぐ	呪具
すいき	水鬼
すみか	棲家	棲み家	棲み処	住処	住み処
せいか	聖化
せいむ	聖務
せきか	石化
せっか	雪花	雪華
せりふ	台詞
せんぎ	戦技
ぜんぎ	前戯
そうが	双牙
そのめ	園女
たいが	胎芽
たきぎ	薪木
だせき	蛇石
だのみ	恃み
だるけ	ダル家
ちゅう	蟲
ちよう	地耀
つうだ	痛打
てだれ	手練れ	手練
てっぴ	鉄皮
てふだ	手札
とうか	灯火
とびて	跳び手	飛び手
とりて	捕り手
ねほり	根堀り
はくひ	白皮
はしり	奔り
はとう	波濤
はほり	葉堀り
はるか	遙か
ひいし	火石
ひたい	額
ひつぎ	棺
ひばご	卑罵語
ひょう	雹
びそく	鼻側
びへい	備兵
ふじゅ	付呪
ふちん	不沈
ふとう	不凍
ほこん	捕魂
ほりて	掘り手
ぼうふ	亡夫
ぼしょ	墓所
ぼせき	母石
ぼろや	ボロ家
まてき	魔笛
まよけ	魔除け
まろけ	マロ家
めじか	雌鹿	牝鹿
もらけ	モラ家
もりて	守り手	護り手
やかた	館
やから	輩
やけど	火傷
ゆかん	湯灌
ようば	妖婆
ようび	耀日
よこて	横手
よびて	呼び手
りぃけ	リィ家
りきば	力場
れいし	霊視
わいろ	賄賂
わんぶ	腕部
あだ	仇
いき	閾
いけ	池
うつ	鬱
うば	乳母
かい	戒
かぎ	鉤
かじ	鍛冶	鍜治
かふ	寡夫
がく	咢
きぎ	樹々
きじ	雉	雉子
ぎぐ	戯具
くつ	窟
げき	撃
こて	籠手
ごや	小屋
さく	柵
さん	桟
しき	屍鬼
ずき	好き
ずみ	済
その	園
たみ	民
ちき	痴気
とう	痘
なた	鉈
のう	嚢
のみ	鑿
はら	肚
ひそ	ヒ素
ふん	吻
へや	部屋
べや	部屋
まき	薪
むか	霧化
むし	蟲
もや	靄
もり	銛
やつ	奴
ゆり	百合
よぼ	夜母
き	紀
